30,17
##############################
#                            #
# #####                 #### #
# ##                      ## #
# #                        # #
#                            #
#                            #
#                            #
#                            #
#                            #
#                            #
#                            #
# #                        # #
# ##                      ## #
# ####                  #### #
#                            #
##############################
E 1,1 28,1 14,8
